11111111111111111111111111111111111111111111111111111111111111111111111111111111111111111111111111111111111111111111111111111111111111111
        2       2       2       2       2       3       2       2       2       2       2       2       3       2       2       3       2
        2       2       2       2       2               2       2       3       2       3       2               2       2               2
        2       2       3       2       3               2       2               2               2               3       2               2
        3       2               2               4       2       2               2               3       4               3       4       2
                3               3               2       3       2       4       2       4               2                       2       2
                        4               4       2               3       2       3       2               2       4               2       2
        4               2               2       2                       2               2       4       2       2       4       2       2
        2       4       2       4       2       2       4               2               2       2       2       2       2       2       2
        2       2       2       2       2       2       2       4       2       4       2       2       2       2       2       2       2
11111111111111111111111111111111111111111111111111111111111111111111111111111111111111111111111111111111111111111111111111111111111111111
